127,76,269,76,269,99,127,99
113,333,235,333,235,345,113,345
284,335,403,335,403,346,284,346
737,68,846,68,846,93,737,93
287,370,402,370,402,382,287,382
297,1008,388,1009,388,1035,297,1034
532,372,696,372,696,383,532,383
737,1084,892,1084,892,1104,737,1104
738,1028,849,1028,849,1052,738,1052
111,368,231,368,231,381,111,381
815,139,903,139,903,151,815,151
512,1226,573,1226,573,1238,512,1238
103,123,191,123,191,133,103,133
507,1062,578,1062,578,1074,507,1074
815,103,886,103,886,114,815,114
100,108,181,108,181,120,100,120
808,1100,886,1100,886,1113,808,1113
681,344,757,344,757,355,681,355
306,203,380,203,380,214,306,214
97,269,143,269,143,281,97,281
520,1144,593,1144,593,1176,520,1176
672,330,753,330,753,341,672,341
641,184,706,184,706,195,641,195
565,343,615,343,615,357,565,357
897,1086,945,1086,945,1112,897,1112
707,372,774,372,774,383,707,383
472,94,540,94,540,105,472,105
191,123,240,123,240,133,191,133
344,1224,411,1224,411,1237,344,1237
862,122,912,122,912,133,862,133
833,1060,901,1060,901,1077,833,1077
643,27,696,27,696,46,643,47
938,1266,987,1266,987,1298,938,1298
348,1100,414,1100,414,1112,348,1112
759,1262,814,1262,814,1281,759,1281
325,254,394,254,394,264,325,264
100,219,154,219,154,230,100,230
833,68,896,68,896,93,833,92
824,185,892,185,892,196,824,195
187,203,243,203,243,214,187,214
655,1167,720,1167,721,1201,656,1201
906,1038,952,1038,952,1054,906,1054
758,1057,815,1057,815,1077,758,1077
99,1011,145,1011,145,1022,99,1022
552,25,605,25,605,43,552,43
679,1079,726,1079,726,1101,679,1101
896,294,929,294,929,308,896,308
613,329,651,329,651,341,613,341
195,1164,230,1164,230,1177,195,1177
819,1146,869,1146,869,1175,819,1175
647,1101,723,1101,723,1117,647,1117
651,1227,718,1227,718,1239,651,1239
886,1172,940,1172,940,1204,886,1204
536,329,585,330,585,340,536,340
126,139,164,139,164,149,126,149
606,28,641,28,641,46,606,46
690,100,736,99,736,114,690,114
861,1032,902,1032,901,1052,861,1052
384,1049,415,1049,415,1060,384,1060
687,1024,728,1024,728,1045,687,1045
873,309,930,309,930,321,873,321
525,1100,560,1100,560,1113,525,1113
762,1220,815,1220,815,1243,762,1243
170,1228,206,1229,206,1242,170,1242
183,167,224,167,224,177,183,177
603,308,681,307,681,321,603,322
872,155,904,155,904,169,872,169
510,71,583,71,583,83,510,83
837,170,879,170,879,180,837,180
680,1054,723,1054,723,1071,680,1071
243,202,282,202,282,214,243,214
169,1152,209,1152,209,1163,169,1163
191,153,229,153,229,163,191,163
826,121,858,121,858,134,826,134
142,1049,170,1049,170,1060,142,1060
633,154,665,154,664,169,633,169
160,979,198,979,198,991,160,991
687,121,723,121,723,133,687,133
350,292,382,292,382,307,350,307
393,219,419,219,419,231,393,231
97,139,123,139,123,149,97,149
725,1056,755,1056,755,1075,725,1075
635,344,677,344,677,354,635,355
126,253,158,253,158,265,126,265
199,140,227,140,227,150,199,150
352,220,387,220,387,230,352,230
456,1061,493,1061,493,1073,456,1073
522,343,563,343,563,354,522,355
826,1217,859,1217,859,1238,826,1238
145,235,198,236,197,248,145,247
658,137,689,137,689,147,658,147
191,219,251,220,251,230,191,230
398,1062,426,1062,426,1073,398,1073
847,155,872,155,872,167,847,167
633,293,663,293,663,307,633,307
309,220,350,220,350,231,309,231
229,153,267,153,267,163,229,163
228,1062,255,1062,255,1073,228,1073
542,94,577,94,577,105,542,105
97,152,128,152,128,163,97,163
96,976,129,976,129,992,96,992
143,153,163,153,163,163,143,163
633,1063,657,1063,657,1075,633,1075
349,306,378,306,378,318,349,318
625,120,670,120,670,135,625,135
128,978,158,978,158,991,128,992
159,292,180,292,180,303,159,303
305,292,326,292,326,305,305,305
176,306,200,306,200,318,175,318
652,121,688,121,688,132,652,132
643,169,672,169,672,180,643,180
330,293,349,293,349,304,330,304
365,236,401,237,401,249,365,248
356,1063,396,1063,396,1074,356,1074
891,1263,923,1263,923,1286,891,1286
183,292,211,292,211,306,183,306
673,169,703,169,702,180,673,180
119,203,154,203,154,214,119,214
313,1062,336,1062,336,1073,313,1073
876,1220,911,1220,911,1239,876,1239
123,236,141,236,141,247,123,247
648,1086,676,1086,676,1100,648,1100
515,21,549,21,549,41,515,41
226,140,257,140,257,150,226,150
167,139,196,139,196,149,167,149
838,1181,868,1181,868,1205,838,1205
833,1261,863,1261,863,1285,833,1285
589,329,610,329,610,340,589,340
366,1087,395,1087,395,1098,366,1098
95,236,120,235,120,248,95,248
173,1216,203,1216,203,1230,173,1230
92,1061,131,1061,131,1072,92,1072
154,202,185,202,185,216,154,216
311,236,344,236,344,247,311,247
616,343,642,343,642,354,616,354
468,70,506,70,506,83,468,84
219,1036,236,1036,236,1047,219,1047
666,153,691,153,691,165,666,165
128,1037,153,1037,153,1047,128,1047
898,1062,920,1062,920,1079,898,1079
157,219,186,219,186,232,157,232
194,1037,221,1037,221,1047,194,1047
177,1037,196,1037,196,1046,177,1046
610,293,632,293,632,305,610,305
166,153,188,153,188,163,166,163
418,218,442,218,442,231,418,231
125,153,145,153,145,163,125,163
813,154,843,154,843,171,813,170
606,1062,633,1062,633,1073,606,1073
139,166,156,166,156,176,139,176
189,1061,206,1061,206,1072,189,1072
427,1061,446,1061,446,1072,427,1073
579,1061,604,1061,604,1073,579,1073
203,1062,227,1062,227,1074,203,1074
649,329,673,329,673,340,649,340
152,1062,174,1062,174,1073,152,1073
134,291,155,291,155,304,135,304
94,203,119,203,119,214,94,214
925,1064,951,1064,951,1083,925,1083
321,1049,348,1049,348,1060,321,1060
105,1036,129,1036,129,1046,105,1046
793,1059,831,1059,831,1076,793,1076
145,306,172,306,172,318,145,318
159,253,187,253,187,264,159,264
309,306,345,306,345,318,309,318
193,1049,215,1049,215,1060,193,1060
287,1049,307,1049,307,1059,287,1059
131,1062,152,1061,152,1073,132,1073
438,237,462,237,462,248,438,248
253,1062,271,1062,271,1073,253,1073
664,293,684,293,684,305,664,305
149,1162,177,1162,177,1178,149,1178
691,154,715,154,715,166,691,166
417,236,437,236,437,248,417,248
524,1087,548,1087,548,1099,524,1099
103,1048,122,1048,122,1059,103,1059
655,1061,679,1061,679,1073,655,1073
117,167,138,167,138,176,117,176
96,253,128,253,128,265,96,265
123,1049,140,1049,140,1060,123,1060
343,237,364,237,364,247,343,247
173,1062,192,1062,192,1072,173,1073
164,1011,185,1011,185,1021,164,1021
170,1049,193,1049,193,1059,170,1059
231,1048,260,1048,260,1060,231,1060
272,1062,288,1062,288,1072,272,1072
152,1037,177,1037,177,1048,152,1048
269,1049,289,1049,289,1059,269,1059
366,1049,383,1049,383,1059,366,1059
252,1049,273,1049,273,1060,252,1060
159,166,184,166,184,176,159,176
290,1061,313,1061,313,1072,290,1072
475,1061,502,1061,502,1073,475,1073
875,294,893,294,893,307,875,307
349,1049,367,1049,367,1059,349,1059
335,1062,356,1062,356,1073,335,1073
306,254,328,254,328,265,307,265
