129,74,271,76,271,100,129,98
215,106,386,107,386,122,215,121
109,369,232,366,232,380,109,383
301,1008,385,1006,386,1031,302,1033
734,1028,857,1030,856,1049,734,1048
280,369,401,368,401,383,280,383
819,100,887,101,887,115,819,114
116,330,229,331,229,347,116,345
110,106,191,109,190,122,110,119
939,1264,988,1267,987,1297,937,1294
640,183,706,182,706,194,640,196
107,120,186,121,186,133,106,132
743,1080,839,1082,839,1101,743,1099
885,1169,941,1171,940,1204,883,1202
844,1059,915,1061,915,1077,843,1076
472,92,543,91,543,104,473,106
675,328,758,329,758,342,675,341
737,66,836,64,836,92,738,94
663,1170,723,1170,723,1198,663,1199
510,1225,571,1224,571,1238,510,1239
96,268,141,269,141,282,96,280
681,342,764,343,764,356,681,356
650,1226,717,1224,717,1239,650,1241
107,217,150,219,150,232,107,230
638,372,701,371,701,383,639,384
510,69,581,71,580,85,510,84
568,370,640,367,640,382,568,384
760,1263,812,1261,813,1282,761,1284
875,308,928,309,927,321,875,320
857,120,909,121,908,135,856,133
824,137,866,138,866,152,823,151
325,202,373,204,373,216,325,214
344,1223,408,1222,408,1236,344,1237
819,1144,873,1146,872,1174,818,1173
303,332,400,333,400,347,302,346
645,28,692,27,693,45,645,46
162,1164,204,1165,204,1178,161,1177
484,237,568,237,569,249,484,249
523,1145,589,1143,590,1170,524,1172
706,370,773,369,773,383,706,384
144,1007,217,1010,216,1024,143,1022
673,1083,728,1083,728,1099,673,1098
341,1100,419,1101,419,1114,341,1112
312,234,359,235,359,248,311,248
760,1057,827,1059,827,1073,760,1071
821,1087,890,1087,889,1102,821,1101
350,251,401,252,400,265,349,264
650,168,697,169,697,182,650,181
825,183,892,183,892,196,825,196
469,70,510,70,510,84,469,84
903,1035,948,1035,948,1053,903,1053
129,234,189,234,189,248,129,248
101,1059,146,1061,146,1073,100,1071
185,106,281,110,281,122,184,119
835,168,879,170,878,183,835,181
861,1033,904,1034,903,1053,861,1052
533,328,584,327,584,339,533,341
160,978,199,978,198,993,160,992
320,251,375,253,375,265,320,264
688,101,737,101,737,114,688,115
169,1150,208,1150,208,1163,169,1163
856,136,905,137,904,151,855,151
305,217,355,218,355,231,305,231
159,107,238,109,238,122,158,119
499,1061,552,1060,552,1072,500,1073
895,1084,944,1085,943,1110,895,1109
192,218,249,218,249,231,192,232
555,24,601,23,601,42,556,43
548,370,605,368,606,382,549,384
429,1061,497,1061,497,1072,429,1073
691,1027,730,1027,730,1045,690,1044
99,1010,149,1010,149,1022,99,1023
155,291,185,292,185,304,155,303
875,1218,912,1218,913,1240,875,1241
538,92,581,91,581,104,538,105
647,1102,727,1101,727,1114,647,1115
634,292,664,293,664,305,634,304
608,292,638,293,638,305,608,305
243,202,281,204,281,216,243,214
173,1215,203,1216,203,1228,173,1228
118,202,155,203,155,216,117,215
616,343,646,343,646,354,616,354
891,294,930,295,929,309,890,307
192,203,242,203,242,216,192,216
822,120,866,121,865,135,822,134
568,343,607,344,607,355,568,354
197,1165,230,1165,230,1177,197,1177
522,343,568,342,568,353,523,354
693,1055,724,1055,724,1071,692,1070
97,977,129,978,129,991,97,990
151,218,190,220,189,233,151,231
659,134,690,133,690,147,660,147
836,68,897,67,898,93,836,94
765,1220,809,1221,808,1239,765,1239
346,306,379,307,378,320,346,319
391,218,420,219,419,231,390,230
607,29,640,28,641,45,608,46
629,307,681,307,681,321,629,320
657,121,688,120,689,132,657,133
818,1100,890,1100,890,1113,818,1113
190,121,256,121,256,132,190,133
363,236,402,237,402,250,362,249
169,305,204,306,204,319,169,318
98,235,124,237,123,250,97,248
97,252,127,253,127,266,97,265
607,306,652,307,651,319,606,319
873,154,904,155,903,169,872,168
192,151,229,151,229,163,192,162
103,1047,140,1049,140,1060,103,1058
183,166,227,166,227,177,183,177
883,1262,921,1263,921,1284,883,1284
155,252,193,250,193,264,156,266
517,21,546,20,546,40,517,41
634,155,666,154,666,168,634,169
315,1061,353,1061,352,1073,315,1072
309,306,349,306,349,318,309,319
667,154,691,154,691,166,667,166
144,304,178,304,178,318,144,318
148,1165,187,1165,187,1177,148,1177
407,235,438,236,438,250,407,249
625,121,655,121,656,134,625,135
415,219,443,220,442,233,414,231
307,291,335,292,334,305,307,304
150,1036,177,1036,177,1048,151,1048
347,217,389,217,389,231,347,231
322,292,350,293,349,305,321,304
525,1102,559,1101,559,1114,525,1114
921,1060,946,1061,945,1080,920,1079
614,329,657,328,657,341,614,342
96,202,123,203,123,216,96,215
171,1229,206,1229,206,1242,171,1242
302,202,347,201,347,215,302,215
351,293,383,294,383,305,350,304
199,1060,227,1061,226,1073,199,1072
815,154,847,155,846,168,815,167
130,978,159,978,159,991,130,992
179,291,210,293,210,304,179,302
122,253,156,254,155,266,122,265
553,237,585,238,585,249,553,248
364,1086,397,1086,398,1098,364,1098
516,371,545,370,545,383,517,384
534,1061,603,1061,603,1073,534,1074
282,335,317,334,317,346,282,347
340,165,378,167,377,178,339,177
316,1048,347,1048,347,1060,316,1059
873,293,905,293,905,308,873,308
729,1057,760,1057,760,1070,729,1070
524,1087,546,1086,547,1098,524,1099
684,120,731,121,731,134,684,133
808,121,838,122,837,134,807,133
139,290,165,291,164,305,138,304
363,1061,398,1061,398,1073,363,1073
587,329,611,329,611,342,587,343
640,343,673,343,673,354,641,354
195,137,237,139,236,150,195,148
659,293,686,294,686,305,659,304
155,202,183,204,182,216,154,214
436,236,461,237,460,250,436,249
636,329,671,329,671,341,636,341
303,252,339,252,339,265,303,266
688,154,713,155,713,166,688,165
638,166,677,166,677,180,638,180
844,153,874,154,874,167,844,166
212,137,249,138,248,149,212,148
815,137,845,138,844,152,815,151
